58 = { 5670 }
59 = { 4816 }
60 = { 5429 }
61 = { 4474 }
64 = { 5396 }
65 = { 5443 }
67 = { 5490 }
