58 = { 4909 }
59 = { 5479 }
60 = { 3330 }
61 = { 3557 }
62 = { 5380 }
63 = { 5431 }
64 = { 2137 }
65 = { 4414 }
66 = { 1440 }
67 = { 1978 }
68 = { 5459 }
69 = { 3349 }
70 = { 1555 }
71 = { 5512 }
72 = { 5434 }
208 = { 5343 }
209 = { 4582 }
210 = { 1281 }
211 = { 211 }
212 = { 5390 }
213 = { 3245 }
214 = { 9194 }
332 = { 5726 }
333 = { 5605 }
334 = { 3148 }
